111111111111111111111111111111111111111111111111
10000000000000000000000000000000000000000ECCCC01
100010001011101001001100101000100011100111000C01
100011011001001011010010110001010010010010000C01
100010101001001101011100110010101010100010000C01
100010001011101001001110101010001010010010000C01
100000000000000000000000000000000000000000000C01
100000000000000000000000000000000000000000000C01
100000000000000000000000000000000000000000000C01
100000000000000000000000000000000000000000000C01
100000000000000000000000000000000000000000000C01
100000000000000000000000000000000000000000000C01
100000000000000000000000000000000000000000000C01
100000000000000000000000000000000000000000000C01
100000000000000000000000000000000000000000000C01
100000000000000000000000000000000000000000000C01
100000000000000000000000000000000000000000000C01
100000000000000000000000000000000000000000000C01
100000000000000000000000000000000000000000000C01
100000000000000000000000000000000000000000000C01
100000000000000000000000000000000000000000000C01
100000000000000000000000000000000000000000000C01
100000000000000000000000000000000000000000000C01
1PCCCCCCCCCCCCCCCCCCCCCCCCCCCCCCCCCCCCCCCCCCCC01
111111111111111111111111111111111111111111111111
