1111111111111111111111111111
100010001000C0000000010001P1
1101010101100000000000C000E1
11000100000100000000100C00C1
1111111111111111111111111111
